Viola tricolor	Core_Eudicots_Rosids
Hemerocallis fulva	Monocots
Buxus megistophylla	Core_Eudicots_Rosids
Juniperus chinensis	Conifers
Bambusa multiplex	Monocots
Pittosporum tobira	Core_Eudicots_Asterids
Photinia serratifolia	Core_Eudicots_Rosids
Loropetalum chinense	Core_Eudicots
Oxalis corniculata	Core_Eudicots_Rosids
Fatsia japonica	Core_Eudicots_Asterids
Salix babylonica	Core_Eudicots_Rosids
Prunus Cerasifera	Core_Eudicots_Rosids
Nandina domestica	Basal_Eudicots
Ilex cornuta	Core_Eudicots_Asterids
Ophiopogon bodinieri	Monocots
Osmanthus fragrans	Core_Eudicots_Asterids
Viburnum odoratissimum	Core_Eudicots_Asterids
Cinnamomum camphora	Magnoliids
Podocarpus macrophyllus	Conifers
Nerium oleander	Core_Eudicots_Asterids
Hydrangea macrophylla	Core_Eudicots
Abelia biflor	Core_Eudicots_Asterids
Vinca major	Core_Eudicots_Asterids
Rosa chinensis	Core_Eudicots_Rosids
Erigeron annuus	Core_Eudicots_Asterids
Lysimachia christinae	Core_Eudicots_Asterids
Rhododendron simsii	Core_Eudicots_Asterids
Paederia foetida	Core_Eudicots_Asterids
Chimonanthus praecox	Magnoliids
Castanopsis tibetana	Core_Eudicots_Rosids
Magnolia multiflora	Magnoliids
Corylus chinensis	Core_Eudicots_Rosids
Castanea mollissima	Core_Eudicots_Rosids
Ulmus pumila	Core_Eudicots_Rosids
Hibiscus mutabilis	Core_Eudicots_Rosids
Koelreuteria integrifoliola	Core_Eudicots_Rosids
Hedera nepalensis	Core_Eudicots_Asterids
Sambucus williamsii	Core_Eudicots_Asterids
Sloanea sinensis	Core_Eudicots_Rosids
Camellia japonica	Core_Eudicots_Asterids
Diospyros kaki	Core_Eudicots_Asterids
Acer ginnala	Core_Eudicots_Rosids
Symplocos sumuntia	Core_Eudicots_Asterids
Pteris ensiformis	Leptosporangiate_Monilophytes
Dryopteris filix-mas	Leptosporangiate_Monilophytes
Machilus leptophylla	Magnoliids
Machilus thunbergii	Magnoliids
Osmanthus fragrans	Core_Eudicots_Asterids
Acer buergerianum	Core_Eudicots_Rosids
Magnolia grandiflora	Magnoliids
Elaeagnus argyi	Core_Eudicots_Rosids
Boehmeria nivea	Core_Eudicots_Rosids
Manglietia yuyuanensis	Magnoliids
Sabina chinensis	Conifers
Acer palmatum	Core_Eudicots_Rosids
Ilex chinensis	Core_Eudicots_Asterids
Euonymus carnosus	Core_Eudicots_Rosids
Viburnum macrocephalum	Core_Eudicots_Asterids
Jasminum nudiflorum	Core_Eudicots_Asterids
Bambusa multiplex	Monocots
Pinus thunbergii?	Conifers
Canna generalis	Monocots_Commelinids
Aucuba japonica	Core_Eudicots_Asterids
Phyllostachys aureosuleata	Monocots
Torreya grandis	Conifers
Pyracantha fortuneana	Core_Eudicots_Rosids
Michelia figo	Magnoliids
Phoebe sheareri	Magnoliids
Camellia japonica	Core_Eudicots_Asterids
Ilex hylonoma	Core_Eudicots_Asterids
Berberis julianae	Basal_Eudicots
Cyrtomium caryotideum	Leptosporangiate_Monilophytes
Mahonia fortunei	Basal_Eudicots
Quercus fabri	Core_Eudicots_Rosids
Lithocarpus brevicaudatus	Core_Eudicots_Rosids
Photinia lasiogyna	Core_Eudicots_Rosids
Phyllostachys praecox	Monocots
Pterocarya stenoptera	Core_Eudicots_Rosids
Viburnum macrocephalum	Core_Eudicots_Asterids
Illicium lanceolatum	Magnoliids
Erigeron acer	Core_Eudicots_Asterids
Lagerstroemia indica	Core_Eudicots_Rosids
Cyclobalanopsis glauca	Core_Eudicots_Rosids
Sapindus mukorossi	Core_Eudicots_Rosids
Corylopsis sinensis	Core_Eudicots
Ehretia thyrsiflora	Core_Eudicots_Asterids
Plantago asiatica	Core_Eudicots_Asterids
Centella asiatica	Core_Eudicots_Asterids
Clinopodium chinense	Core_Eudicots_Asterids
Cornus officinalis	Core_Eudicots_Asterids
Artemisia selengensis	Core_Eudicots_Asterids
Dicranopteris dichotoma	Leptosporangiate_Monilophytes
Woodwardia japonica	Leptosporangiate_Monilophytes
Punica granatum	Core_Eudicots_Rosids
Hemerocallis fulva	Monocots
Zelkova serrata	Core_Eudicots_Rosids
Sophora japonica	Core_Eudicots_Rosids
Elaeocarpus glabripetalus	Core_Eudicots_Rosids
Sapium sebiferum	Core_Eudicots_Rosids
Ginkgo biloba	Ginkgoales
Dianthus chinensis	Core_Eudicots
Vaccaria segetalis	Core_Eudicots
Cosmos bipinnata	Core_Eudicots_Asterids
Cosmos?sulphureus	Core_Eudicots_Asterids
Zinnia elegans	Core_Eudicots_Asterids
Impatiens balsamina	Core_Eudicots_Asterids
Salvia viridis	Core_Eudicots_Asterids
Spiraea japonica	Core_Eudicots_Rosids
Campsis grandiflora	Core_Eudicots_Asterids
Cerasus subhirtella	Core_Eudicots_Rosids
Parthenocissus quinquefolia	Core_Eudicots_Rosids
Echinochloa caudata	Monocots
Zephyranthes grandiflora	Monocots
Verbena hybrida	Core_Eudicots_Asterids
Coreopsis drummondii	Core_Eudicots_Asterids
Tiarella polyphylla	Core_Eudicots
Rosmarinus officinalis	Core_Eudicots_Asterids
Pennisetum setosum	Monocots
Sedum hispanicum	Core_Eudicots
Digitalis purpurea	Core_Eudicots_Asterids
Asclepias curassavica	Core_Eudicots_Asterids
Pseudolysimachion rotundum	Core_Eudicots_Asterids
Rosa chinensis	Core_Eudicots_Rosids
Hylotelephium verticillatum	Core_Eudicots
Ruellia brittoniana	Core_Eudicots_Asterids
Crocosmia crocosmiflora	Monocots
Polygonum chinense	Core_Eudicots
Brainea insignis	Leptosporangiate_Monilophytes
Rhododendron pulchrum	Core_Eudicots_Asterids
Cuphea hookeriana	Core_Eudicots_Rosids
Punica granatum	Core_Eudicots_Rosids
Hypericum monogynum	Core_Eudicots_Rosids
Cercis chinensis	Core_Eudicots_Rosids
Lantana camara	Core_Eudicots_Asterids
Rosa multiflora	Core_Eudicots_Rosids
Tagetes erecta	Core_Eudicots_Asterids
Zinnia elegans	Core_Eudicots_Asterids
Lavandula angustifolia	Core_Eudicots_Asterids
Eriobotrya japonica	Core_Eudicots_Rosids
Schefflera octophylla	Core_Eudicots_Asterids
Bougainvillea glabra	Core_Eudicots
Hosta albo-marginata	Monocots
Begonia semperflorens	Core_Eudicots_Rosids
Sedum sarmentosum	Core_Eudicots
Chlorophytum comosum	Monocots
Setcreasea purpurea	Monocots_Commelinids
Nelumbo nucifera	Basalmost_angiosperms
Miscanthus floridulus	Monocots
Tulbaghia violacea	Monocots
Sedum lineare	Core_Eudicots
Pontederia cordata	Monocots_Commelinids
Metasequoia glyptostroboides	Conifers
Hibiscus syriacus	Core_Eudicots_Rosids
Lythrum salicaria	Core_Eudicots_Rosids
Glochidion puberum	Core_Eudicots_Rosids
Thalia?dealbata	Monocots_Commelinids
Cerasus pseudocerasus	Core_Eudicots_Rosids
Citrus reticulata	Core_Eudicots_Rosids
Amygdalus persica	Core_Eudicots_Rosids
Actinidia Chinensis	Core_Eudicots_Asterids
Vaccinium Spp	Core_Eudicots
Digitaria sanguinalis	Monocots
Hylocereus undatus	Core_Eudicots
Vitis vinifera	Core_Eudicots_Rosids
Tetrastigma hemsleyanum	Core_Eudicots_Rosids
Echinochloa crusgali	Monocots
Euphorbia thymifolia	Core_Eudicots_Rosids
Wisteria sinensis	Core_Eudicots_Rosids
Edgeworthia chrysantha	Core_Eudicots_Rosids
Cucurbita moschata	Core_Eudicots_Rosids
Alternanthera sessilis	Core_Eudicots
Setaria viridis	Monocots
Corypha umbraculifera	Monocots_Commelinids
Musa basjoo	Monocots_Commelinids
Yucca smalliana	Monocots
Adiantum capillus-veneris	Leptosporangiate_Monilophytes
Nephrolepis auriculata	Leptosporangiate_Monilophytes
Lygodium japonicum	Leptosporangiate_Monilophytes
Neottopteris nidus	Leptosporangiate_Monilophytes
Angiopteris fokiensis	Eusporangiate_Monilophytes
Spathiphyllum kochii	Monocots
Pachira macrocarpa	Monocots_Commelinids
Epipremnum aureum	Monocots
Anthurium andraeanum	Monocots
Kalanchoe blossfeldiana	Core_Eudicots
Nymphaea alba	Basalmost_angiosperms
Macrothelypteris oligophlebia	Leptosporangiate_Monilophytes
Ulmus parvifolia	Core_Eudicots_Rosids
Lepisorus thunbergianus	Leptosporangiate_Monilophytes
Carya illinoensis	Core_Eudicots_Rosids
Plantago asiatica	Core_Eudicots_Asterids
Dichondra repens	Core_Eudicots_Asterids
Cunninghamia lanceolata	Conifers
Celtis sinensis	Core_Eudicots_Rosids
Canna indica	Monocots_Commelinids
Cedrus deodara	Conifers
Mirabilis jalapa	Core_Eudicots
Podocarpus neriifolius	Conifers
Litsea coreana	Magnoliids
Lindera megaphylla	Magnoliids
Triticum aestivum	Monocots_Commelinids
Centaurea cyanus	Core_Eudicots_Asterids
Spinacia oleracea	Core_Eudicots
Fagopyrum esculentum	Core_Eudicots
Nelumbo nucifera	Basal_Eudicots
Zea mays	Monocots_Commelinids
Secale sylvestre £¨Triticale rimpau£©	Monocots_Commelinids
Avena sativa	Monocots_Commelinids
Panicum miliaceum	Monocots_Commelinids
Cucumis sativus	Core_Eudicots_Rosids
Lactuca sativa	Core_Eudicots_Asterids
Lactuca sativa?var?longifoliaf. Lam	Core_Eudicots_Asterids
Setaria italica	Monocots_Commelinids
Sorghum bicolor	Monocots_Commelinids
Agrostemma githago	Core_Eudicots
Ricinus communis	Core_Eudicots_Rosids
Oryza sativa	Monocots_Commelinids
Abelmoschus esculentus	Core_Eudicots_Rosids
Secale cereale	Monocots_Commelinids
Pontederia cordata	Monocots_Commelinids
Agropyron cristatum	Monocots_Commelinids
Lactuca sativa	Core_Eudicots_Asterids
Allium fistulosum	Monocots
Sesamum indicum	Core_Eudicots_Asterids
Papaver rhoeas	Basal_Eudicots
Tropaeolum majus	Core_Eudicots_Rosids
Capsicum annuum	Core_Eudicots_Asterids
Chrysanthemum coronarium	Core_Eudicots_Asterids
Libanotis seseloides	Core_Eudicots_Asterids
Sambucus williamsii	Core_Eudicots_Asterids
Elymus dahuricus	Monocots_Commelinids
Setaria viridis	Monocots_Commelinids
Celosia argentea	Core_Eudicots
Gypsophila paniculata	Core_Eudicots
Magnolia multiflora	Magnoliids
Trifolium pratense	Core_Eudicots_Rosids
Lythrum salicaria	Core_Eudicots_Rosids
Brachypodium distachyum	Monocots_Commelinids
Medicago sativa	Core_Eudicots_Rosids
Solanum lycopersicum	Core_Eudicots_Asterids
Glycine max	Core_Eudicots_Rosids
Cucurbita pepo	Core_Eudicots_Rosids
Lagenaria siceraria (Molina) Standl.	Core_Eudicots_Rosids
Pisum sativum?var.?saccharatum	Core_Eudicots_Rosids
Citrullus lanatus	Core_Eudicots_Rosids
Ceratophyllum demersum	Basalmost_angiosperms
Euonymus alatus	Core_Eudicots_Rosids
Vigna radiata	Core_Eudicots_Rosids
Physalis Pubescens	Core_Eudicots_Asterids
Benincasa hispida	Core_Eudicots_Rosids
Amaranthus tricolor	Core_Eudicots
Helianthus annuus	Core_Eudicots_Asterids
Canavalia gladiata	Core_Eudicots_Rosids
Ipomoea aquatica	Core_Eudicots_Asterids
Cucurbita moschata	Core_Eudicots_Rosids
Vigna unguiculata	Core_Eudicots_Rosids
Brassica oleracea var. italica	Core_Eudicots_Rosids
Brassica chinensis var. parachinensis	Core_Eudicots_Rosids
Capsella bursa-pastoris	Core_Eudicots_Rosids
Mentha haplocalyx	Core_Eudicots_Asterids
Lagenaria siceraria?(Molina) Standl	Core_Eudicots_Rosids
Cucumis melo	Core_Eudicots_Rosids
Phaseolus vulgaris	Core_Eudicots_Rosids
Luffa cylindrica	Core_Eudicots_Rosids
Cucumis melo	Core_Eudicots_Rosids
Cucumis melo	Core_Eudicots_Rosids
Perilla frutescens	Core_Eudicots_Asterids
Momordica charantia	Core_Eudicots_Rosids
Luffa cylindrica	Core_Eudicots_Rosids
Brassica chinensis	Core_Eudicots_Rosids
Allium fistulosum	Monocots
Lablab purpureus	Core_Eudicots_Rosids
Glycine max	Core_Eudicots_Rosids
Phaseolus vulgaris	Core_Eudicots_Rosids
Arachis hypogaea	Core_Eudicots_Rosids
Saccharum officinarum	Monocots_Commelinids
Brassica oleracea	Core_Eudicots_Rosids
Brassica pekinensis	Core_Eudicots_Rosids
Brassica napus	Core_Eudicots_Rosids
Brassica alboglabra	Core_Eudicots_Rosids
Brassica narinosa	Core_Eudicots_Rosids
Raphanus sativus	Core_Eudicots_Rosids
Nicotiana tabacum	Core_Eudicots_Asterids
Hordeum marinum	Monocots_Commelinids
Hymenocallis littoralis	Monocots
Begonia semperflorens	Core_Eudicots_Rosids
Pelargonium hortorum	Core_Eudicots_Rosids
Salvia splendens	Core_Eudicots_Asterids
?Impatiens hawkeri	Core_Eudicots_Asterids
Rudbeckia hirta	Core_Eudicots_Asterids
Nephrolepis cordifolia	Leptosporangiate_Monilophytes
Salvinia natans?	Leptosporangiate_Monilophytes
Vallisneria natans	Monocots
Cabomba caroliniana	Basalmost_angiosperms
Phragmites australis	Monocots
Saururus chinensis	Magnoliids
Eichhornia crassipes	Monocots_Commelinids
Ludwigia adscendens	Core_Eudicots_Rosids
Sagittaria trifolia	Monocots
Hydrocleys nymphoides	Monocots
Phoebe bournei	Magnoliids
Cinnamomum septentrionale	Magnoliids
Lindera erythrocarpa	Magnoliids
Laurus nobilis	Magnoliids
Keteleeria cyclolepis	Conifers
Pseudotsuga sinensis	Conifers
Cephalotaxus sinensis	Conifers
Cephalotaxus fortunei	Conifers
Podocarpus fleuryi	Conifers
Podocarpus nagi	Conifers
Podocarpus macrophyllus	Conifers
Keteleeria davidiana	Conifers
Abies firma	Conifers
Tsuga chinensis	Conifers
Tsuga longibracteata	Conifers
Pinus bungeana	Conifers
Pinus armandii	Conifers
Pinus thunbergii	Conifers
Pinus glabra	Conifers
Larix kaempferi	Conifers
Magnolia soulangeana	Magnoliids
Magnolia delavayi	Magnoliids
Asimina triloba	Magnoliids
Magnolia cylindrica	Magnoliids
Liriodendron chinense	Magnoliids
Cercis glabra	Core_Eudicots_Rosids
Cercis racemosa	Core_Eudicots_Rosids
Ribes fasciculatum	Core_Eudicots
Crataegus pinnatifida	Core_Eudicots_Rosids
Laurocerasus zippeliana	Core_Eudicots_Rosids
Cerasus discoidea	Core_Eudicots_Rosids
Cerasus subhirtella	Core_Eudicots_Rosids
Laurocerasus spinulosa	Core_Eudicots_Rosids
Malus mandshurica	Core_Eudicots_Rosids
Tilia oliveri	Core_Eudicots_Rosids
Tilia miqueliana	Core_Eudicots_Rosids
Tilia amurensis	Core_Eudicots_Rosids
Tilia japonica	Core_Eudicots_Rosids
Tilia endochrysea	Core_Eudicots_Rosids
Grewia hirsuto-velutina	Core_Eudicots_Rosids
Reevesia pycnantha	Core_Eudicots_Rosids
Aesculus wilsonii	Core_Eudicots_Rosids
Meliosma myriantha	Basal_Eudicots
Meliosma oldhamii	Basal_Eudicots
Meliosma flexuosa	Basal_Eudicots
Meliosma myriantha	Basal_Eudicots
Meliosma rigida	Basal_Eudicots
Meliosma parviflora	Basal_Eudicots
Toxicodendron sylvestre	Core_Eudicots_Rosids
Acer truncatum	Core_Eudicots_Rosids
Rubus tephrodes	Core_Eudicots_Rosids
Ilex macrocarpa	Core_Eudicots_Asterids
Buxus sinica	Basal_Eudicots
Osmanthus fragrans	Core_Eudicots_Asterids
Jasminum mesnyi	Core_Eudicots_Asterids
Sapindus mukorossi	Core_Eudicots_Rosids
Osmanthus matsumuranus	Core_Eudicots_Asterids
Osmanthus heterophyllus	Core_Eudicots_Asterids
Ligustrum japonicum	Core_Eudicots_Asterids
Ligustrum sinense	Core_Eudicots_Asterids
Fraxinus chinensis	Core_Eudicots_Asterids
Fraxinus mandschurica	Core_Eudicots_Asterids
Ilex buergeri	Core_Eudicots_Asterids
Ilex aculeolata	Core_Eudicots_Asterids
Ilex viridis	Core_Eudicots_Asterids
Ilex rotunda	Core_Eudicots_Asterids
Euscaphis japonica	Core_Eudicots_Rosids
Catalpa ovata	Core_Eudicots_Asterids
Catalpa speciosa	Core_Eudicots_Asterids
Ehretia macrophylla	Core_Eudicots_Asterids
Catalpa bungei	Core_Eudicots_Asterids
Premna microphylla	Core_Eudicots_Asterids
Adina rubella	Core_Eudicots_Asterids
Viburnum plicatum	Core_Eudicots_Asterids
Viburnum dilatatum	Core_Eudicots_Asterids
Viburnum rhytidophyllum	Core_Eudicots_Asterids
Gardenia jasminoides	Core_Eudicots_Asterids
Vitex negundo	Core_Eudicots_Asterids
Callicarpa cathayana	Core_Eudicots_Asterids
Heptacodium miconioides	Core_Eudicots_Asterids
Abelia chinensis	Core_Eudicots_Asterids
Weigela floribunda	Core_Eudicots_Asterids
Weigela coraeensis	Core_Eudicots_Asterids
Viburnum setigerum	Core_Eudicots_Asterids
Euonymus japonicus	Core_Eudicots_Rosids
Bothrocaryum controversum	Core_Eudicots_Asterids
Cyclobalanopsis jenseniana	Core_Eudicots_Rosids
Cyclobalanopsis gracilis	Core_Eudicots_Rosids
Quercus serrata	Core_Eudicots_Rosids
Castanopsis fordii	Core_Eudicots_Rosids
Cyclobalanopsis sessilifolia	Core_Eudicots_Rosids
Castanopsis carlesii	Core_Eudicots_Rosids
Juglans cinerea	Core_Eudicots_Rosids
Myrica rubra	Core_Eudicots_Rosids
Cudrania tricuspidata	Core_Eudicots_Rosids
Helicia cochinchinensis	Basal_Eudicots
Ficus?Pandurata	Core_Eudicots_Rosids
Morus alba	Core_Eudicots_Rosids
Shaniodendron?subaequale	Core_Eudicots
Ficus erecta	Core_Eudicots_Rosids
Hamamelis mollis	Core_Eudicots
Corylopsis multiflora	Core_Eudicots
Distylium chinense	Core_Eudicots
Corylopsis glandulifera	Core_Eudicots
Sycopsis sinensis	Core_Eudicots
Elaeagnus lanceolata	Core_Eudicots_Rosids
Elaeagnus pungens	Core_Eudicots_Rosids
Lagerstroemia excelsa	Core_Eudicots_Rosids
Lagerstroemia subcostata	Core_Eudicots_Rosids
Syzygium grijsii	Core_Eudicots_Rosids
Acca sellowiana	Core_Eudicots_Rosids
Nyssa sinensis	Core_Eudicots_Rosids
Davidia involucrata	Core_Eudicots_Asterids
Fortunella japonica	Core_Eudicots_Rosids
Citrus maxima	Core_Eudicots_Rosids
Poncirus trifoliata	Core_Eudicots_Rosids
Ptelea polyadenia	Core_Eudicots_Rosids
Evodia rutaecarp	Core_Eudicots_Rosids
Phellodendron amurense	Core_Eudicots_Rosids
Padus wilsonii	Core_Eudicots_Rosids
Vernicia fordii	Core_Eudicots_Rosids
Orixa japonica	Core_Eudicots_Rosids
Armeniaca mume	Core_Eudicots_Rosids
Hovenia acerba	Core_Eudicots_Rosids
Rhamnus globosa	Core_Eudicots_Rosids
Dendrobenthamia capitata	Core_Eudicots_Asterids
Bothrocaryum controversum	Core_Eudicots_Asterids
Euonymus?maackii	Core_Eudicots_Rosids
Cornus controversa	Core_Eudicots_Asterids
Dendrobenthamia japonica	Core_Eudicots_Asterids
Sageretia thea	Core_Eudicots_Rosids
Ziziphus jujuba	Core_Eudicots_Rosids
Paliurus hemsleyanus	Core_Eudicots_Rosids
Rhamnus utilis	Core_Eudicots_Rosids
Rosa bracteata	Core_Eudicots_Rosids
Deutzia scabra	Core_Eudicots
Cerasus serrulata	Core_Eudicots_Rosids
Millettia reticulata	Core_Eudicots_Rosids
Ormosia henryi	Core_Eudicots_Rosids
Dalbergia balansae	Core_Eudicots_Rosids
Lespedeza thunbergii	Core_Eudicots_Rosids
Dalbergia hupeana	Core_Eudicots_Rosids
Caesalpinia decapetala	Core_Eudicots_Rosids
Gleditsia sinensis	Core_Eudicots_Rosids
Gleditsia japonica	Core_Eudicots_Rosids
Gleditsia japonica	Core_Eudicots_Rosids
Robinia pseudoacacia	Core_Eudicots_Rosids
Albizia julibrissin	Core_Eudicots_Rosids
Mucuna sempervirens	Core_Eudicots_Rosids
Prunus salicina	Core_Eudicots_Rosids
Malus pumila	Core_Eudicots_Rosids
Chaenomeles sinensis	Core_Eudicots_Rosids
Malus sieboldii?	Core_Eudicots_Rosids
Amygdalus persica	Core_Eudicots_Rosids
Sinojackia xylocarpa	Core_Eudicots_Asterids
Styrax suberifolius	Core_Eudicots_Asterids
Pterostyrax psilophyllus	Core_Eudicots_Asterids
Diospyros kaki	Core_Eudicots_Asterids
Symplocos chinensis	Core_Eudicots_Asterids
Symplocos paniculata	Core_Eudicots_Asterids
Symplocos sumuntia	Core_Eudicots_Asterids
Symplocos grandis	Core_Eudicots_Asterids
Diospyros rhombifolia	Core_Eudicots_Asterids
Diospyros armata	Core_Eudicots_Asterids
Styrax odoratissimus	Core_Eudicots_Asterids
Styrax japonicus	Core_Eudicots_Asterids
Styrax confusus	Core_Eudicots_Asterids
Melliodendron xylocarpum	Core_Eudicots_Asterids
Fontanesia fortunei	Core_Eudicots_Asterids
Buddleja lindleyana	Core_Eudicots_Asterids
Buddleja officinalis	Core_Eudicots_Asterids
Erythrina corallodendro	Core_Eudicots_Rosids
Castanea mollissima	Core_Eudicots_Rosids
Gordonia acuminata	Core_Eudicots_Asterids
Xylosma racemosum	Core_Eudicots_Rosids
Camellia octopetala	Core_Eudicots_Asterids
Aspidistra obianceifolia	Monocots
Eurya emarginata	Core_Eudicots_Asterids
Livistona chinensis	Monocots_Commelinids
Camellia uraku	Core_Eudicots_Asterids
Typha angustifolia	Monocots_Commelinids
Portulaca oleracea	Core_Eudicots
Aphananthe aspera	Core_Eudicots_Rosids
Melia azedarach	Core_Eudicots_Rosids
Cayratia japonica	Core_Eudicots_Rosids
Cleome spinosa	Core_Eudicots_Rosids
Coleus scutellarioides	Core_Eudicots_Asterids
Arabidopsis thaliana	Core_Eudicots_Rosids
Asparagus officinalis	Monocots
Ficus tikoua	Core_Eudicots_Rosids
Solanum melongena	Core_Eudicots_Asterids
Myriophyllum aquaticum	Magnoliids
Typha orientalis	Monocots_Commelinids
Caragana sinica	Core_Eudicots_Rosids
Rhododendron molle	Core_Eudicots_Asterids
Reynoutria japonica	Core_Eudicots
Zenia insignis	Core_Eudicots_Rosids
Eurya alata	Core_Eudicots_Asterids
Ternstroemia gymnanthera	Core_Eudicots_Asterids
Stewartia sinensis	Core_Eudicots_Asterids
Poliothyrsis sinensis	Core_Eudicots_Rosids
Adinandra millettii	Core_Eudicots_Asterids
Alternanthera sessilis	Core_Eudicots
Iris pseudacorus	Monocots
Colocasia antiquorum	Monocots
Arundo donax	Monocots
Phragmites australis	Monocots
Reineckia carnea	Monocots
Yucca gloriosa	Monocots
Saccharum arundinaceum	Monocots
Vetiveria zizanioides	Monocots
Zizania?latifolia	Monocots
Pollia japonica	Monocots_Commelinids
Hosta plantaginea	Monocots
Speirantha gardenii?	Monocots
Calystegia hederacea	Core_Eudicots_Asterids
Penstemon laevigatus	Core_Eudicots_Asterids
Houttuynia cordata	Magnoliids
Hemiboea subacaulis	Core_Eudicots_Asterids
Blastus dunnianus	Core_Eudicots_Rosids
Neolepisorus ovatus	Leptosporangiate_Monilophytes
Zingiber mioga	Monocots_Commelinids
Mussaenda esquirolli	Core_Eudicots_Asterids
Selaginella uncinata	Lycophytes
Selaginella moellendorffii	Lycophytes
Woodwardia prolifera	Leptosporangiate_Monilophytes
Diplazium chinense	Leptosporangiate_Monilophytes
Macrothelypteris torresiana	Leptosporangiate_Monilophytes
Arachniodes exilis	Leptosporangiate_Monilophytes
Colysis elliptica	Leptosporangiate_Monilophytes
Colysis elliptica	Leptosporangiate_Monilophytes
Coniogramme japonica	Leptosporangiate_Monilophytes
Deparia lancea	Leptosporangiate_Monilophytes
Microlepia marginata	Leptosporangiate_Monilophytes
Dryopteris crassirhizoma	Leptosporangiate_Monilophytes
Pteris multifida	Leptosporangiate_Monilophytes
Polystichum putuoense	Leptosporangiate_Monilophytes
Woodwardia japonica	Leptosporangiate_Monilophytes
Equisetum arvense	Eusporangiate_Monilophytes
Ophioglossum vulgatum	Eusporangiate_Monilophytes
Ceratophyllum demersum	Basalmost_angiosperms
Cyperus rotundus	Monocots_Commelinids
Psilotum nudum	Eusporangiate_Monilophytes
Hydrocharis dubia	Monocots
Trapa natans?	Magnoliids
Nuphar pumila	Basalmost_angiosperms
Alisma plantago-aquatica	Monocots
Hydrilla verticillata	Monocots
Saxifraga stolonifera	Core_Eudicots
Ardisia silvestris	Core_Eudicots_Asterids
Ardisia japonica?	Core_Eudicots_Asterids
Chloranthus fortunei	Chloranthales
Pteris semipinnata	Leptosporangiate_Monilophytes
Davallia mariesii	Leptosporangiate_Monilophytes
Pseudocyclosorus esquirolii	Leptosporangiate_Monilophytes
Pinellia pedatisecta	Monocots
Sambucus chinensis	Core_Eudicots_Asterids
Pellionia radicans	Core_Eudicots_Rosids
Torenia fournieri	Core_Eudicots_Asterids
Schoenoplectus triqueter	Monocots_Commelinids
Plagiomnium acutum	Mosses
Fissidens nobilis	Mosses
Dicranum scoparium	Mosses
Marchantia polymorpha	Liverworts
Haplocladium microphyllum?	Mosses
Thuidium philibertii	Mosses
Hypnum plumaeforme	Mosses
Atrichum rhystophyllum	Mosses
Marchantia polymorpha	Liverworts
Cibotium barometz	Leptosporangiate_Monilophytes
Microsorium fortunei	Leptosporangiate_Monilophytes
Adiantum flabellulatum	Leptosporangiate_Monilophytes
Lindsaea orbiculatum	Leptosporangiate_Monilophytes
Huperzia serrata	Lycophytes
Pteris cretica	Leptosporangiate_Monilophytes
Pteris linearis	Leptosporangiate_Monilophytes
Doryopteris concolor	Leptosporangiate_Monilophytes
Pteris ensiformis	Leptosporangiate_Monilophytes
Cyathea dealbata	Leptosporangiate_Monilophytes
Ophioglossum vulgatum	Eusporangiate_Monilophytes
Funaria hygrometrica	Mosses
Alsophila spinulosa?	Leptosporangiate_Monilophytes
Helminthostachys zeylanica	Eusporangiate_Monilophytes
Rhodobryum giganteum	Mosses
Sphagnum palustre	Mosses
Marchantia polymorpha	Liverworts
Odontosoria chinensi	Leptosporangiate_Monilophytes
Corydalis Sheareri	Basal_Eudicots
Orychophragmus violaceus	Core_Eudicots_Rosids
Helleborus thibetanus	Basal_Eudicots
Chloranthus fortunei	Chloranthales
Botryocladia uvaria	Green_Algae
Caulerpa serrulata	Green_Algae
Chladophora	Green_Algae
Laminaria japonica	Chromista_Algae
Pyropia	Red_Algae
Gelidium amansii	Red_Algae
Ulva lactuca	Green_Algae
Leucobryum glaucum	Mosses
Selaginella nipponica	Lycophytes
?Racomitrium canescens	Mosses
Hypnum plumaeforme	Mosses
Hylocomium splendens	Mosses
Haplocladium microphyllum?	Mosses
Taxiphyllum taxirameum	Mosses
Myuroclada maximowiczii	Mosses
Pogonatum aloides	Mosses
Dicranum scoparium	Mosses
Hypopterygium japonicum	Mosses
Lycopodium japonicum	Lycophytes
Selaginella tamariscina	Lycophytes
Lindsaea orbiculata	Leptosporangiate_Monilophytes
Chloranthus fortunei	Chloranthales
Stenoloma chusanum	Leptosporangiate_Monilophytes
Commelina communis	Monocots_Commelinids
